OOOOOOOOOO
O O    O O
O O      O
O OOOO OOO
O .      U
O O      O
O O O.OOOO
O . O    O
OOOOOOOOOO
