OOOOOOOOOOOOOOOOOOOOOOOOOOOOOOOOOOOOOOOOOOOOOOOOOOOOOOOOOOOOOOO
O                 O                    O                      O
O.OOOOOOOOOOOOOO.OOOO.OOOOOOOO.OOOOOOOOOOO.OOOOOOOOOOOOOOOOOOOO
O         O     X         O            O                      O
OOOOOO.OOOOOOOOOOOOOOOOOOOOOOOOOOOO.OOOOOOOOOOOOO.OOOOOOOOOOOOO
O                          O             O               O    O
OOOOOOOOOOOOOOOOOOOOOOOOOOOOOOOOOOOOOOOOOOOOOOOOOOOOOOOO.O.OO.O
O                                                        O  O O
O.OOOOOOOOOOOOOOOO.OOOOOOOOOOOOOOOOOOOOOOOOOOOOOOOOOOOOOOOO.O.O
O                     O               O        O            O O
OOOOOOOOOOOOOOOOOOOOOOOOOOOOOOOOOOOOOOOOOOOOOOOOOOOOOOOOOOOOO.O
O    O                                       .                O
OOOUOOOOOOOOOOOOOOOOOOOOOOOOOOOOOOOOOOOOOOOOOOOOOOOOOOOOOOOOOOO
